000000000000000000000000
000000000000000000000000
000000001000001001100000
000000002010102000200000
000000002001002001210000
000000000000000000000000
000000000000000000000000
000000000000000000000000
000000001100110000000040
000000112200221100000010
000111222200222211100000
111222222233222222211111