100
100
000000000000000000000000
000000000000000000000000
000000000000000000000000
000000000000000000000000
000000000000000000000000
000000000000000000000000
000000000000000000000000
000000000000000000000000
000000000110011000000040
000000011220022110000010
000011122220022221110000
111122222223322222221111
enem:700 200 r