50
200
000000000000000000000000000000000000000000000000
000000000000000000000000000000000000000000000000
000000000000000000000000000000000000000000000000
000000000000000000000000000000000000000000000000
000000000000000000000000000000000000000000000004
000000000000000000000000000000000000000000000011
000000000000000000000000000000000000000000011122
000000000000000000000000000000000000000011122222
000000000000000000000000000000000111111122222222
000000000000000000000000000111111222222222222222
000000000000000000111111111222222222222222222222
111111111133331111222222222222222222222222222222
enem:600 50 l
enem:1200 150 l
enem:2000 300 l